11111111111111
1P000000CCCCC1
11111100000001
11100000001111
10012340111111
111ECC000000C1
11111111111111
