11111111111
1P000000001
10000000000
10000000E01
1C000C0CC01
11110011111
