111111111
1P0C00001
100CCC111
10C0CC1E1
111111111
