111111111
100000001
1P0000001
111100001
100000001
111000001
10E000001
111111111
