111111111
1P0000001
10C000001
10000B001
111111101
111101111
111E11111
111111111
