11111111111
1P000000001
100000B0000
10000000E01
1C000C0CC01
11110011111
