11111111111111111111111111111111111111111111111111111111111
11P11111111111111111111111111111111111111111111111111111111
100CCCCCCC111111111000111111111100011111111C0B11111111B0C11
1000000000111111100010001111110001000111111C001111111100C11
111100C111111110000111000111100011000011111C001111111100C11
111100C111111000011111100011000111110000111C001111111100C11
111100C111111100001111111CCCC11111000011111C001111111100C11
111100C111111110000111111111111110000111111C001111111100C11
111100C111111111110001111111111100001111111C001111111100C11
111100C111111111111000111111110001111111111C001111111100C11
111100C111111111111100011111100011111111111C001111111100C11
1B00000000111111111110001111000111111111111CCCCCCCCCCCCCC11
10000000000000000000000000000000000000000000000000000000011
11111111111110111111111111111111111011111111111111111111111
1111111111111000000000000000000000000000000000000000000E111
11111111111111111111111111111111111111111111111111111111111